15
15
*5#++B+B+++++$3
55#+++++++###$$
###$++++++#+*#+
++$@$+++$$$3+#+
+++$$+++$+4###+
A++++###$@+$++A
+++++#++$#$$+++
A++++#+5+#+++++
+++$$#$++#++++A
+++$+@$###+++++
+###4+$+++$$+++
+#+3$$$+++$##++
+#*+#++++++#$$+
$####+++++++$##
3$+++B++B++++#5